+---------------------------------------+
|             |                         |
|             |               ###       |
|   ----------+     |         ###       |
|             |     |                   |
|             |     |                   |
|             +-----+-----              |
|                   |                   |
|                   |                   |
|                   |    #####          |
|                   |    #####          |
|   #######         |                   |
|   #######         |                   |
|   #######         |                   |
|                   |                   |
|                            +----------┼
|                            |          |
|                            |          |
|    #########               |          |
|    #########               |          |
|                                       |
|                                       |
+---------------------------------------+