│───────────────────────────────────────
│             │                        │
│             │               ███      │
│   ──────────┼    │          ███      │
│             │    │                   │
│             │    │                   │
│             ┼────┼──────             │
│                  │                   │
│                  │                   │
│                  │    █████          │
│                  │    █████          │
│   ███████        │                   │
│   ███████        │                   │
│   ███████        │                   │
│                  │                   │
│                           ┼──────────┼
│                           │          │
│                           │          │
│    █████████              │          │
│    █████████              │          │
│                                      │
│                                      │
│──────────────────────────────────────│
